NO textures/wall_north.png
SO textures/wall_south.png
WE textures/wall_west.png
EA textures/wall_east.png

F 220,100,0
C 225,30,0

111111
10N101
101001
100N01
111111
