NO    ./../textures/north.png
SO ./../textures/south.png
WE          ./../textures/west.png
EA ./../textures/east.png

F 220,100,0
   C   225,30,0

        1111111111111111
        1000000000000001
    1111001110111000011
    100100100010001001
111100100100010011111
100000100N0000100001
10111010101111011101
10001000000000010001
11101011111111010111
1000001   1   100001
1011101 11111 101101
1000001 10001 100001
1111101 111011101001
    100100000000001
    110011111101111
     10000000001
      111111111



	 
	 

