NO ./../textures/north.png
SO ./../textures/south.png
WE ./../textures/west.png

EA ./../textures/east.png

F 220,20,0
C 225,30,0

111111
100101
101001
100N01
111111

