NO ./../textures/north.png
SO ./../textures/south.png
WE ./../textures/west.png
EA ./../textures/east.png

F 220,100,146
C 225,30,089

111111
100101
101001
1100N1
111111
