NO ./../textures/north.png
SO ./../textures/south.png
WE ./../textures/west.png
EA ./../textures/east.png

F 220,100,0
C 225,30,0

1111 1111
1001 1111
1011    1
1001111 1
10001 111
1N1011101
111111111
